SO ./textures/Wall/SOUTH.xpm
NO ./textures/Wall/NORTH.xpm
EA ./textures/Wall/EAST.xpm
WE ./textures/Wall/WEST.xpm

F 220,100,0
C 225,30,0

        1111111111111
        1100000000011
        1100000E00011
        1111111111111
