111111111
100000001
100000001
100000101
100000001
100000001
111111111
