NO ./textures/Wall/NORTH.xpm
SO ./textures/Wall/SOUTH.xpm
WE ./textures/Wall/WEST.xpm
EA ./textures/Wall/EAST.xpm

F 62,62,62
C 62,62,62

1111111111111111111111111
1000100100000000000000001
10000N0001000000000000001
1111111111111111111111111
