WE /asdasdasdasdasd.xpm
EA ./asdasdasdasdasd.xpm
SO ./asdasdasdasdasd.xpm
NO FirstValue.xpm               
C 0,0,0
F 0,0,0



111111111111111111111111
100000000000E00000000001
100000000000000000000001
100000000000000000000001
111111111111111111111111
