1111111111111111111111111111
1000111111110000000000000001
1000111111110000000000000001
1000000000000000011111110001
1111111111111111111111111111
