NO ./textures/Wall/NORTH.xpm
SO ./textures/Wall/SOUTH.xpm
WE ./textures/Wall/WEST.xpm
EA ./textures/Wall/EAST.xpm

F 62,62,62
C 62,62,62

11111
1NC01
11111
