
                             









              WE /asdasdasdasdasd.xpm
EA ./asdasdasdasdasd.xpm
SO ./textures/Wall/Second.xpm               
NO ./textures/Wall/First.xpm              d 
C 0,0,255
F 255,0,0



111111111111111111111111
100000000000E00000000001
100000000000000000000001
100000000000000000000001
111111111111111111111111
