                      WE                    /asdasdasdasdasd.xpm
C 250,220,2

EA ./asdasdasdasdasd.xpm
SO                 ./asdasdasdasdasd.xpm
                            NO FirstValue.xpm               

F                  251                  ,                       234 ,         2


111111111111111111111111
100000000000E00000000001
100000000000000000000001
100000000000000000000001
111111111111111111111111
