
                             



                                            



WE .xpm
EA ./asdasdasdasdasd.xpm
SO ./textures/Wall/Second.xpm               
NO ./textures/Wall/First.xpm              
C 255,0                ,0
F 255,0,0

111111111111111111111111
111111111111111111111111
1111111111111              1111 
111111111111111111111
100000000000E11000000001
100000000111100000000001
  10000001  100000000001
111111111111111111111111
