NO textures/no.xpm
SO textures/so.xpm
WE textures/we.xpm
EA textures/ea.xpm


F 160,120,80
C 220,230,240

        1111111111111111111111111
        1100000000110000000111111
        1000000001110000010110001
        1001000000000000000110001
111111111011000001110000000000001
110000000011000001110111111111111
11110111111111011100000010001
11110111111111011111010010001
11000000110101011100000011001
11001000100000001100000000001
11000000000100001101010010001
1100000111010101111111110N0111
11110111 1111101 101111010001
11111111 1111111 111111111111
