F 160,120,80
C 220,230,240

NO textures/no.xpm
SO textures/so.xpm
WE textures/we.xpm
EA textures/ea.xpm

1111111111111111111
1001001000001001001
100000000W000000001
1000010011111000001
1111000000000001111
1000000101010000001
1111111111111111111

