NO textures/no.xpm
SO textures/so.xpm
WE textures/we.xpm
EA textures/ea.xpm

F 160,120,80
C 220,230,240

111111111111
1      11111
111111110001
100000010011
10S000000001
111111111111
11         1
111111111111
