NO textures/no.xpm
SO textures/so.xpm
WE textures/we.xpm
EA textures/ea.xpm

F 160,120,80
C 220,230,240

111111111111111111111
1000000000000000000E1
111111111111111111111
